#Shape	ShapeDim	Representation	RepDim	In	Out	Canonical	Details
Point	3D	RPoint	3D
Points	3D	RPoints	3D
Line	3D	RLinePoints	3D
Lines	3D	RLinesPoints	3D
Polyline	3D	RPolylinePoints	3D
Polygon	3D	RPolylinePoints	3D
Cuboid	3D	RCuboid1	3D
Ellipsoid	3D	RHalfAxes	3D
PolylineSpline	3D	RPolylinePoints	3D
PolygonSpline	3D	RPolylinePoints	3D
Cylinder	3D	REllipticCylinder1	3D
Arc	3D	RArc1	3D
GreyMask	3D	RGreyMask	3D
BitMask	3D	RBitMask	3D
Mesh	3D	RMesh	3D
AffineTransform	3D	RAffineTransform	3D
AbstractTransform	3D	RAbstractTransform	3D
Text	3D	RText	2D
Value	nD	RValue	nD
Values	nD	RValues	nD
Range	nD	RRange1	nD
ExtrudeDim	nD	RExtrude	nD
CombineDim	nD	RSet	nD
Set	nD	RSet	nD
Group	nD	RSet	nD
Bitwise	3D	RBitwise	3D
Custom	3D	RCustom	3D
Property	nD	RProperties	nD
